are	AA R
are(2)	ER
call	K AO L
dial	D AY AH L
down	D AW N
for	F AO R
for(2)	F ER
for(3)	F R ER
list	L IH S T
listen	L IH S AH N
music	M Y UW Z IH K
next	N EH K S T
next(2)	N EH K S
number	N AH M B ER
play	P L EY
player	P L EY ER
previous P R IY V IY AH S
quit	K W IH T
search	S ER CH
show	SH OW
siri	S IH R IY
stop	S T AA P
to	T UW
to(2)	T IH
to(3)	T AH
up	AH P
volume	V AA L Y UW M
we	W IY
where	W EH R
